map.png
0 70 70

00000000000
22022022022
22222222222
22222222222
30000000000
30000000000
30000000000
30000000000
30000000000
00000S00000
     
