map.png
0 70 70

22022022022
22222222222
22222222222
22222222222
00000000000
00000000000
00000000000
00000000000
00000000000
00000S00000
     
