map.png
0 70 70

00000000000
22022022022
22222222222
22222222222
00000000000
000000000003
30000000000
000000000003
30000000000
00000S00000
     
