map.png
2 70 70
1 288 720 70 70
2 150 150 80 70

22122122122
22222222222
22222222222
00000000000
00000000000
00000000000
00000000000
00000000000
00000000000
00000S00000