map.png
3 70 70
1 288 720 70 70
2 0 0 0 0


22122122122
22222222222
22222222222
22222222222
00000S00000
00000000000
00000000000
00000000000
00000000000
00000000000
     